W W W W W W W W W W W W W W W W
W 1 -1 B B -1 d -1 B -1 W -1 -1 -1 -1 W
W -1 W -1 -1 -1 -1 B B W W -1 -1 d -1 W
W B -1 T -1 -1 -1 -1 -1 -1 -1 -1 W B B W
W -1 -1 T B -1 -1 -1 -1 -1 -1 o T -1 -1 W
W W B B W -1 B -1 -1  B B -1 -1 -1 -1 W
W -1 -1 -1 -1 -1 -1 -1 -1 B B -1 -1 -1 -1 W
W -1 T B W -1 -1 -1 -1 d -1 -1 -1 -1 -1 W
W -1 -1 o -1 -1 -1 -1 -1 -1 -1 -1 -1 -1 -1 W
W -1 -1 -1 W -1 -1 -1 -1 T -1 -1 -1 -1 B W
W -1 -1 -1 B -1 -1 -1 W -1 T -1 -1 B B W
W -1 B B B B -1 -1 -1 W -1 -1 o T T W
W T -1 W W -1 -1 -1 -1 B -1 -1 -1 -1 -1 W
W -1 d -1 -1 -1 B -1 -1 B -1 -1 -1 T B W
W -1 -1 -1 -1 B -1 -1 -1 T d T W W B W
W W W W W W W W W W W W W W W W